stage1
3,3,3,3,3,3,3,3,3,3,
3,0,0,0,0,0,0,0,0,3,
3,0,0,0,0,0,0,0,0,3,
3,0,0,0,0,0,0,0,0,3,
3,0,0,0,0,0,2,0,0,3,
3,0,3,0,0,0,0,0,0,3,
3,3,3,3,0,0,0,0,0,3,
3,0,3,0,0,0,0,0,0,3,
3,0,0,0,0,0,0,0,0,3,
3,0,0,1,0,0,0,0,0,3,
3,0,0,0,0,0,0,0,0,3,
3,0,0,0,0,0,0,0,0,3,
3,0,0,0,0,0,0,0,0,3,
3,4,0,0,0,0,0,0,5,3,
3,3,3,3,3,3,3,3,3,3,

