stage1
3,3,3,3,3,3,3,3,3,3,
3,3,3,3,3,3,3,3,0,3,
3,0,0,0,0,0,0,0,0,3,
3,0,0,0,0,0,0,0,0,3,
3,0,0,0,0,0,0,0,0,3,
3,0,0,0,0,0,0,0,0,3,
3,0,0,0,0,0,0,0,0,3,
3,0,0,0,0,0,0,0,0,3,
3,0,0,0,0,0,0,0,0,3,
3,0,0,1,0,0,0,0,0,3,
3,0,0,0,0,0,0,0,0,3,
3,0,0,0,0,0,0,0,0,3,
3,0,0,0,0,0,0,0,2,3,
3,4,0,0,0,0,0,0,0,3,
3,3,3,3,3,3,3,3,3,3,
stage2
3,3,3,3,3,3,3,3,3,3,
3,0,0,0,0,0,0,0,0,3,
3,0,3,0,0,0,0,0,0,3,
3,3,3,0,0,0,0,0,0,3,
3,0,3,0,0,0,0,0,0,3,
3,0,0,0,0,0,0,0,0,3,
3,0,0,0,0,0,0,0,0,3,
3,0,0,2,0,0,0,0,0,3,
3,0,0,0,0,0,0,0,0,3,
3,0,0,0,0,0,0,0,4,3,
3,0,0,0,0,0,0,0,3,3,
3,0,0,1,0,0,0,0,3,3,
3,0,0,0,0,0,0,0,3,3,
3,0,0,5,0,0,0,0,0,3,
3,3,3,3,3,3,3,3,3,3,
stage3
3,3,3,3,3,3,3,3,3,3,
3,0,0,0,0,3,0,0,0,3,
3,0,0,0,0,3,0,0,0,3,
3,4,0,0,0,0,0,0,0,3,
3,3,0,0,0,0,0,0,2,0,
3,0,0,0,0,0,0,0,0,3,
3,0,0,0,0,0,0,0,0,3,
0,2,0,0,0,0,3,3,3,3,
3,3,0,0,0,0,3,0,0,3,
0,0,0,3,3,3,3,3,0,0,
3,0,0,1,3,0,0,0,0,0,
3,0,0,3,3,0,0,3,0,3,
3,0,0,0,0,0,0,3,0,3,
3,0,0,6,0,0,0,0,0,3,
0,3,3,3,0,0,0,0,3,3,
stage4
0,0,0,0,3,3,3,3,3,3,
0,0,0,8,3,0,0,0,0,3,
0,8,3,3,7,0,0,0,2,0,
0,8,3,3,7,0,0,0,0,3,
0,0,0,0,0,0,0,0,0,3,
0,0,9,0,0,0,0,0,0,0,
3,3,3,3,3,0,3,0,0,0,
3,0,0,0,8,3,3,7,0,0,
3,2,0,0,8,3,3,7,0,0,
3,0,3,3,3,6,3,0,0,0,
3,0,0,0,0,0,3,0,0,0,
3,0,0,0,0,0,0,0,0,0,
3,0,0,0,0,0,0,0,1,0,
3,4,0,0,0,0,0,0,0,3,
3,3,3,3,3,3,3,3,3,3,
stage5
3,3,3,3,3,3,3,3,3,3,
3,0,0,0,0,0,0,0,3,3,
3,6,0,3,0,0,0,0,0,3,
3,0,3,3,0,2,3,0,0,3,
3,0,0,3,0,3,4,0,0,3,
3,0,0,0,0,5,3,3,0,3,
3,0,3,7,0,3,5,0,0,3,
3,0,3,2,0,0,0,0,0,3,
3,0,3,3,3,0,0,0,3,3,
3,0,0,3,0,2,0,0,0,3,
0,0,0,0,0,0,0,0,0,3,
3,0,0,3,0,0,0,0,0,3,
3,0,0,3,3,0,0,0,3,3,
3,3,0,0,0,3,1,0,0,3,
3,3,3,3,3,3,3,3,3,3,
